'1846.4 826.8 720.1'
'1846.4 826.8 720.1'
0
'1563.8 1317.2 808.1'
'1563.8 1317.2 808.1'
0
'1142.3 1248.1 808.1'
'1142.3 1248.1 808.1'
0
'1162.7 1800.7 1048.1'
'1162.7 1800.7 1048.1'
0
'880.0 1596.0 504.1'
'880.0 1596.0 504.1'
0
'616.6 801.4 152.1'
'616.6 801.4 152.1'
0
'1632.1 325.9 280.1'
'1632.1 325.9 280.1'
0
'1625.7 931.3 280.1'
'1625.7 931.3 280.1'
0
'1922.8 1496.1 528.1'
'1922.8 1496.1 528.1'
0
'1191.5 1841.3 528.1'
'1191.5 1841.3 528.1'
0
'1200.2 1388.1 536.1'
'1200.2 1388.1 536.1'
0
'1090.8 859.1 528.1'
'1090.8 859.1 528.1'
0
'395.4 328.9 728.1'
'395.4 328.9 728.1'
0
'1540.5 665.9 728.1'
'1540.5 665.9 728.1'
0
'1540.8 334.8 728.1'
'1540.8 334.8 728.1'
0
'1116.2 159.7 1176.1'
'1116.2 159.7 1176.1'
0
'1146.7 609.3 1176.1'
'1146.7 609.3 1176.1'
0
'1155.1 386.5 1176.1'
'1155.1 386.5 1176.1'
0
'1552.7 365.0 1176.1'
'1552.7 365.0 1176.1'
0
'1534.1 186.9 1176.1'
'1534.1 186.9 1176.1'
0
'1758.3 1823.2 1752.1'
'1758.3 1823.2 1752.1'
0
'1608.9 1080.4 1752.1'
'1608.9 1080.4 1752.1'
0
'1756.4 1298.5 1752.1'
'1756.4 1298.5 1752.1'
0
'1634.5 1854.6 1752.1'
'1634.5 1854.6 1752.1'
0
'916.6 1363.2 1432.1'
'916.6 1363.2 1432.1'
0
'150.3 1498.0 1432.1'
'150.3 1498.0 1432.1'
0
'388.6 1184.8 1432.1'
'388.6 1184.8 1432.1'
0
